|------------------|
|                  |
|             3   2|
|         9 2   7  |
|     3     5      |
|     4         5  |
|       1     9 6 3|
|   8       4     7|
|     6     3   4 5|
|   1     2 7     8|
|------------------|
|------------------|
|                  |
|             2   1|
|           8 5   6|
|     3            |
|   4     7        |
|     9     1 8 6 4|
|   6 4   9       3|
|   2 7     4     8|
|   9     5 7   1  |
|------------------|
|------------------|
|                  |
|               1 8|
|       7     6 3  |
|     5            |
|     7       2   3|
|     1 2 3     8 4|
|   1       7      |
|   5     4       9|
|   2 4 9   8 3 7  |
|------------------|
|------------------|
|                  |
|               2 3|
|         2 7 1 4  |
|     5            |
|   1              |
|     4 3   2   1 6|
|   6       1     9|
|     2   8     7  |
|   8 1   7 4 2 6  |
|------------------|
|------------------|
| 1         7   9  |
|   3     2       8|
|     9 6     5    |
|     5 3     9    |
|   1     8       2|
| 6         4      |
| 3             1  |
|   4             7|
|     7       3    |
|------------------|
|------------------|
|   6 1     7     3|
|   9 2     3      |
|                  |
|     8 5 3        |
|             5   4|
| 5         8      |
|   4             1|
|       1 6   8    |
| 6                |
|------------------|
|------------------|
|   4 6     5 7    |
|   9   9          |
|   9       1     6|
|             9    |
|   3              |
| 4     5 2       8|
|   8           7  |
| 5 7   3       8 2|
| 2           3    |
|------------------|
|------------------|
| 2         7   5  |
|             3    |
|     1 2   8      |
| 7         3     1|
|     2         6  |
|   6       1 4    |
|     4 1   6     8|
|     8       7    |
|   5           9  |
|------------------|
|------------------|
|   8         1 5  |
| 4   6 5   9   8  |
|           8      |
|                  |
|     2   4       3|
| 3     8   1      |
| 9       7        |
| 6               4|
| 1   5         9  |
|------------------|
|------------------|
| 8                |
|     3 6          |
|   7     9   2    |
|   5       7      |
|         4 5 7    |
|       1       3  |
|     1         6 8|
|     8 5       1  |
|   9         4    |
|------------------|